1111111111111111
100000000001C101
100000000000E001
1PCCCCCCCCCCC001
1111111111111111