1111111111111
100C00C0C0001
1001000001111
1C0000C000B11
11110C00C0001
1EP000C000C01
1111111111111
