1111111111111
10000000C0001
1001000001111
100000C000B11
11110C00C0001
1EP0000000001
1111111111111
