1111111111111
10000000C0001
1000000001111
100000C000011
11111C00C0001
1PE0000000001
1111111111111
