1111111111111
100C00C0C0001
100100E001111
1C0000C000B11
11110C00C0001
10P000C000C01
1111111111111
1