1111111111
1CE00C0P11
1000000001
1000000001
1000B00001
1111111111
