1111111111
1CE00C0P11
1111111111
