1111111111
1CE0000P11
1111111111