11111111111
1P000C00001
10000C00001
10000000001
11111111111
100000E0001
11111111111