11111111111111
100C00C0C00B01
10000000000001
1P0000000000E1
11111111111111