111111111111111111
1000000000C0000001
100000000000000001
111111111111111111
10000000000000P001
1000E0000000000001
111111111111111111
