1111111111111
10000001C0001
1P00001E11111
100000C100B11
11111000C0001
10000C0000001
1111111111111
