1111111111111
10000P00C0001
1P00000E01111
100000C000B11
11111000C0001
10000C0000001
1111111111111
